11111111111111111111111111111111111111111
10000000000010000000010000100000000000001
10000000000010000000110000100000000000001
10000000000010000000100000000000000000001
10000000000010000000100000000000000000001
10000000000011100000100000000000000000001
10000000000000100000100000000000100000001
10000001000000100000100000000000111111111
10000001000000100000100000100000000000001
11111111000000000000100000000000000000001
10000000000000000000100000000000000000001
10000000000000000000100000000000000000001
10000000000000000000111111100000000000001
10000000000000100000100000100011111000001
10000000000111100000100000100110000000001
10000000000100000000100000111100000000001
10000000000100000001100000000000000000001
11111111111100000000000000000000000000001
10000000000000000000000000000000000000001
10000000000000000000000000000000000000001
10000000000000000000111110000000000000001
10000000000000011000100000000000000000001
10000100000000000000100000000000000000001
10000000000000000000100000000000000000001
10000000000000000000100000000000000000001
10000000000000000000100000000000000000001
10000000010000111111100000000000100000001
11111111110000100000000000000000100000001
10000000010000100000000000000000100000001
10000000010000111000000000000000100000001
10000000010000001000000000000000111111111
10000000010000000000000000000000000000001
10000000000000000000000000010000000000001
10000000000000000000000000010000000000001
10000000000000000000000000010000000000001
10000100000000000000000000010000000000001
10000000000001111111111110010000000000001
10000000000001000000000011110000000000001
10000000000001000000000000000000000000001
10000000000001000000000000000000000000001
11111111111111111111111111111111111111111
