111111111111111111111111111111111111111111111111111111111111
100000011111100001111000000000000001111100000000000001111111
100000011111000001110000000000000000111000000000000000111111
100000000011000001110000000000000000111000000000000000111111
100000000011000000110000000000000000111000000000000000000011
100000000011000000110000000000000000111000000000000000000001
100000000011000000110000000100000000111000000000000000000001
100001111111000000110000000000000000111000000000000000000001
100001111111000000110000000000000000111000000000000000000001
100001100000000001110000000000000000111000000000000000000001
100001100000000001110000000000000000111000000000000000000001
100001000000000001110000000000001111111000000000000000000001
100000000000001111110000000000011111110000000000000000000001
100000000000111111100000000000011100000000000000000000000001
100000000001110000000000000000011000000000000000000000000001
100000000001100000000000000000011000000000000000000000000001
100000000001100000000000000000011000000000000000000000000001
100000011111100000000000000000011100000000000000000000000001
100000111000000000000000000000011111111111111111100000000001
100001110000000000000000000000001111111111111111000000000001
100001110000000000000000000000000000000000000000000000000001
100001100000000000000000000000000000000000000000000000000001
100001100000000000000000000000000000000000000000000000000001
100001100000000000000000000000000000000000000000000000000001
100001100000000000000000000000000000000000000000000000000001
100001000000000000000000000000000000000000000000000000000011
100001000000000000000000000000000000000000000000000011111111
100001000000000000000000000000000000000011000000000011111111
100001000000000000000000000000000000000011000000000011111111
100001000000000000000000000000000000000011000000000000011111
100001000000000000000000000000000000000011000000000000011111
100001000000000000000000000000000000000011000000000000000001
100001000000001111111111111111100000000011000000000000000001
100001000000011111111111111111110000000011000000000000000001
100001000000011111111111111111110000000011000000000000000001
100000000000011100000000000001110000000011100000000000000001
100000000000011000000000000000110000000011111111111100000001
100000000000011000000000000000110000000011111111111100000001
100000000000011000000000000000110000000011100000000000000001
100000000000011000000000000000110000000011000000000000000001
111100000000011000001000000000110000000011000000000000000001
111111000000011000001000000001110000000011000000000000000001
111110000000011000001111111111110000000011000000000000000001
100000000000011000000111111111100000000011000000000000000001
100000000000011000000000000000000000000011000011111111111111
100000000000011000000000000000000000000011000000000000000011
100000000000011000000000000000000000000011000000000000000001
100000000000011000000000000000000000000011000000000000000001
111111111111111100000000000000000000000111100000000000000011
111111111111111111111111111111111111111111111111111111111111
