11111111111111111111111111111111111111111111111111
10000000000001000000000000100000000000000000000001
10000000000001000000000000100000000000000000000001
10000000000001000000000000100000000000000000000001
10000000000001000000000000100000000000000000000001
10000000000001000000000000100000000000000000000001
10000000000001000000000000100000000000000000000001
10000000000001000000001111100000001110000000000001
10000000000001000000001000000000000010000000000001
11100000011111000000111000000000000010000000000001
10100000110001000001100000000000000010000000000001
10100000100001000001000000000000000011111111111111
10100000111111000001000000000000000000000000000001
10100000000000000001000000000000000000000000000001
11100000000000000001000000000000000000000000000001
10100000000000000001111100000001000000000000000001
10100000000000000000000000000000000000000000000001
10111000000000000000000000000000000000000001111111
10001111100000000000000000000000000000000001000001
10000010000000000000000000000000000000000001000001
10000010000000000000000000000000000000000001000001
10000010000000001111111100000000111111111111000001
10000000000000001000000100000000100000000001000001
10000000000000001100000100000000100000000001000001
10000000000000000100100100000000100000000001000001
10000000000000000100000100000000100000000001000001
10000000000000000100000100000000110000000001110001
10000000000000000100000100000000010000000000010001
10000000000000000111111100000011110000001111110001
10000000000000000000000000000000000000001000000001
11111111100000000000000000000000000000001000000001
10000000100000000000000000000000000000001000000001
10000000100000000000000000000000000000000000000001
10000000100000000000000000000000000000000000000001
10000000100000000001100000000000000000000000000001
11111111100000000001100000000000000000000000000001
10000000000000000000000000000000000000000000000001
10000000000000000000000000001000000100000000000001
10000000000000000000000000001000000100000000000001
10000000000000000000000000001000000100000000000001
10000000000000000000000000001000000010000000000001
10000000000000000000000000001000000010000000000001
10000000000011111111111110001000000010000000000001
10000010000010000000000011111000000011000000000001
10000000000010000000000000000000000001000000000001
10000000000010000000000000000000000001000000000001
10000000000010000000000000000000000001000000000001
10000000000010000000000000000000000001000000000001
10000000000010000000000000000000000001000000000001
11111111111111111111111111111111111111111111111111
